XXXXXXXXXXXXXXX
X             X
X XXXXX XXXXX X
X XS        X X
X XXXXXXXXX X X
X XXXXXXXXX X X
X XXXX      X X
X XXXX XXXX X X
X XXXX XX X X X
X X    XX XXX X
X X XXXXX XXX X
X X XXXXX XXX X
X X         X X
X XXXXXXXXX   X
XFXXXXXXXXXXXXX
