XXXXXXXXSXXXXXXXXXXX
XXXXXX      XXX    X
X      XXXX     XX X
X XXXXXXXXXXX  XX  X
X     XXXXXX    X XX
XXXXX        XXXX XX
XX    XXX X       XX
X    XXXXXXXXXX XXXX
XX  XX        X XX X
XX     XXXXXX      X
XX  XXXX X XXXXXXX X
XX  XX           X X
XX   XXXXXXXXXXX X X
XX                 X
XXXXXXXXXXXXXXXXXXFX